abhisek agrval - amazon.com
ajnan - myntra
ankit chauhan - carwale
ankit rudani - mmt
arzu - yatra
chetanya bhathiya - udemy
charmi - coursera
darshil - youtube
darshit busa - goibibo
dhara - cars24
dharvi - zoom.us
gautam - flipcart
hiren - radixweb.com
hitesh - icicibank.com
jaimin - idbibank.in
jatin - dominoz
jeet - subway.com
jeet vegad - swiggy
kevin - zomato
khushboo - netflix
krutik - shopclues
kuldeep - icicilombard
madni - sonyliv
mansi - mxplayer
manthan - tajhotels.com
mihir - tanisk.co.in
mohit - ola.com
mustafa - instagram 
nensi - whatsapp
pakshal - stackblitz.com
priyanka - phonepay
rahee - uber
rohan - paytm
ruturaj - lapinoj
shailja - picsy
stuti - hotstar
yash - w3school
mensi - tutorials point
dhruv - justdial
deepak - irctc
ritu - naukari.com
abhisek - triavgo



user stroy

what about site is
project name 
usage
features
how many  user functinality
